%%%   %   %   %   % %1%%
%o% % % % % %   % % % %%
% % % % % % %%%%  % % %%
%   % % % %   3% %% % %%
%5  % % % %%%  % %% % %%
%%%%% % % %    %  % % %%
%     % % % %%%%%     %%
%  %%%% %   %   %%%%  %%
%7      %9  % % %    8%%
% %%%%% %%%%% % % %%%%%%
% %           % %      %
% % %%% %%%%% % % %%%%%%
% % %    %4 % % %      %
%   % %% %  % % %%%%%% %
%2  % %  %    %       6%
%%%%%%%%%%%%%%%%%%%%%%%%